﻿#######################################
#.....................................#
#.....................................#
#.....................................#
#.....................................#
#.........#######################.....#
#.........#.....................#.....#
#.........#.....................#.....#
#.........#.....................#.....#
#.........#.........#...........#.....#
#.........#.........####........#.....#
#.........#.........#...........#.....#
#.........#.........#...........#.....#
#.........#.....................#.....#
#.........#.....................#.....#
#.........#...................#####...#
#............................#.....#..#
#...........................#.....#...#
#..........................#.....#....#
#.........................#.....#.....#
#.........................####.#......#
#.....................................#
#.....................................#
#.....................................#
#######################################
.......................................
.......................................
.......................................
.......................................
.......................................
.......................................
.......................................
.......................................
.......................................
.......................................
.......................................
.......................................
.......................................
.......................................
.......................................